+++++++++++++++++
+               +               
+         =     +               
+   +   +++++   +
+   +   +       +               
+=  +   +       +               
+   +   + =     +               
+   +  =+       +               
+       +       +               
+=     ++       +               
+      +       =+               
+   ++++++      +               
+   +           +
+   +   =       +               
+   +   +++++++++               
+   +     =     +               
+ * +         @ +               
+++++++++++++++++
